[
    [
        [10,10,10,10,10,10,10,10,10,10,10,10,10,10,10,10,10,10,10,10,10,10,10,10,10,10,10,10,10,10,10,10,10,10,10,10,10,10,10,10,10,10,10,10,10,10,10,10,10,10],
        [10,11,0,0,0,0,0,0,0,0,0,0,0,0,0,0,0,0,9,10,10,10,10,10,11,0,0,0,0,0,0,0,0,0,0,0,0,10,0,0,0,0,0,0,0,0,0,0,0,10],
        [10,0,0,4,0,0,0,0,0,0,0,0,0,0,0,0,0,0,0,9,10,10,10,11,0,0,0,0,0,0,0,0,0,0,0,0,0,0,0,0,0,0,0,0,0,0,0,0,10,10],
        [10,7,0,0,0,0,0,0,0,0,0,0,0,0,0,2,0,0,0,0,9,10,11,0,0,0,0,0,0,0,0,0,0,0,0,0,0,0,0,0,0,0,0,0,0,0,0,10,10,10],
        [10,10,10,10,10,10,10,10,10,10,10,7,0,0,0,0,0,0,0,0,0,10,0,0,0,0,0,0,0,0,0,2,0,0,0,0,0,0,0,0,0,0,0,0,0,0,10,10,0,10],
        [10,11,0,0,0,0,0,0,0,9,10,10,7,0,0,0,0,0,0,0,0,10,0,0,0,0,0,0,0,0,1,0,0,0,0,0,0,0,0,0,0,0,0,0,0,0,10,0,0,10],
        [10,0,0,0,0,0,0,0,0,0,9,10,10,7,0,0,0,0,0,0,0,10,0,2,0,0,0,0,10,0,0,0,0,0,0,0,10,10,10,10,10,10,10,10,10,0,10,0,0,10],
        [10,0,0,0,0,0,0,0,0,0,0,10,10,10,0,0,0,0,0,0,0,10,0,0,0,0,0,0,10,0,0,0,0,0,0,0,0,0,0,0,0,0,10,10,10,10,10,0,0,10],
        [10,0,0,0,0,2,0,0,0,0,0,10,10,10,0,0,0,0,0,0,0,10,0,0,0,0,0,0,10,0,0,0,0,0,0,0,0,0,0,0,0,0,10,0,10,10,10,0,0,10],
        [10,0,0,0,0,0,0,0,0,0,0,9,10,11,0,0,0,0,1,0,0,10,0,0,0,0,0,0,10,7,0,0,0,0,0,0,0,0,0,0,0,10,10,0,10,0,0,0,0,10],
        [10,0,0,0,0,10,7,0,0,0,0,0,0,0,0,0,0,0,0,0,8,10,0,0,0,0,0,0,10,10,0,0,0,0,0,0,0,0,0,0,10,10,0,0,10,10,0,0,0,10],
        [10,0,0,0,0,0,10,7,0,0,0,0,0,0,0,0,0,0,0,8,10,11,0,0,0,0,0,0,10,10,0,0,0,0,0,0,0,0,0,10,10,0,0,0,10,10,0,0,0,10],
        [10,2,0,0,0,0,0,10,7,0,0,0,0,0,2,0,0,0,8,10,11,0,0,0,0,2,0,8,10,10,0,0,0,0,0,0,0,0,10,10,0,0,0,10,10,10,0,0,0,10],
        [10,0,0,0,0,0,0,0,10,7,0,0,3,0,0,0,0,8,10,11,0,0,0,0,0,0,8,10,10,11,0,0,0,0,0,0,0,0,0,0,0,0,0,0,0,10,0,3,0,10],
        [10,0,0,0,0,0,0,0,0,10,7,0,0,0,0,0,10,10,11,0,1,0,0,0,8,10,10,10,10,0,0,0,3,0,0,0,0,0,0,0,0,0,0,0,10,10,0,0,0,10],
        [10,0,0,0,0,0,0,0,0,0,10,10,10,10,10,10,10,0,0,0,0,0,0,0,10,11,0,0,0,0,0,0,0,0,0,0,0,0,0,0,0,10,10,10,10,10,0,0,0,10],
        [10,0,0,0,2,0,0,0,0,0,0,0,0,0,8,10,0,0,0,0,0,2,0,8,10,0,0,0,0,0,0,0,0,0,0,0,0,10,10,10,10,10,10,0,0,10,0,0,0,10],
        [10,0,0,0,0,0,0,0,0,0,0,0,0,8,10,11,0,0,0,0,0,0,8,10,11,0,0,2,0,0,0,0,0,0,0,0,0,10,10,0,0,0,0,0,0,10,10,0,0,10],
        [10,0,0,0,0,0,0,0,0,0,0,0,0,10,11,0,0,0,3,0,0,8,10,11,0,0,0,0,0,0,0,0,0,0,0,0,0,0,0,0,0,0,0,0,0,0,10,0,0,10],
        [10,0,0,0,0,2,0,0,0,0,0,0,0,0,0,0,0,0,0,0,8,10,11,0,0,0,0,0,0,10,0,0,0,0,0,0,0,0,0,0,0,0,0,10,0,0,0,0,0,10],
        [10,7,0,0,0,0,0,0,0,2,0,0,0,0,0,0,0,0,0,8,10,10,0,0,0,0,0,0,0,10,0,0,0,0,0,0,0,0,0,0,0,0,10,10,0,0,0,0,10,10],
        [10,10,7,0,0,0,0,0,0,0,0,0,0,0,0,0,0,0,8,10,10,10,0,0,0,0,0,0,0,10,0,0,0,0,0,0,0,0,0,0,10,10,10,10,0,0,0,0,10,10],
        [10,10,10,7,0,0,10,0,0,0,0,0,0,0,0,0,0,8,10,10,10,10,7,0,0,0,0,10,10,10,0,0,0,0,0,0,0,0,0,10,10,0,0,10,0,0,0,10,0,10],
        [10,10,10,10,0,0,0,0,0,0,0,0,0,0,0,0,0,10,10,10,10,10,10,0,0,0,0,0,10,10,0,0,0,0,0,0,0,0,0,10,10,0,0,0,0,0,10,10,0,10],
        [10,10,0,0,0,0,0,0,0,0,0,0,0,0,0,0,0,10,10,10,10,0,0,0,0,0,0,0,10,0,0,0,0,0,0,0,0,0,10,10,0,0,0,0,0,0,10,0,10,10],
        [10,0,0,0,0,0,0,0,0,0,0,0,0,0,0,0,0,10,10,10,10,0,0,0,0,0,0,0,10,0,0,0,0,0,0,0,0,10,10,10,0,0,0,0,0,0,10,0,10,10],
        [10,0,0,0,0,0,0,0,0,0,0,0,0,0,0,0,0,10,10,10,10,0,0,0,0,0,0,0,10,0,0,0,0,0,0,0,0,10,10,0,0,0,0,0,0,0,10,10,10,10],
        [10,0,0,0,0,0,10,10,10,10,0,0,0,0,0,0,0,0,10,0,0,0,0,0,0,0,0,0,10,0,0,0,0,0,0,0,0,10,10,0,0,0,0,0,3,0,0,10,0,10],
        [10,0,0,0,10,10,10,10,10,10,0,0,0,0,0,0,0,0,0,0,0,0,0,0,0,0,0,0,10,0,0,0,0,0,0,0,0,0,0,0,0,0,0,0,0,0,10,10,0,10],
        [10,0,0,10,10,10,10,10,0,0,0,0,0,0,0,0,0,0,0,0,0,0,0,0,0,0,0,0,10,10,0,0,0,0,0,0,0,0,0,0,0,0,0,0,0,0,10,10,10,10],
        [10,0,10,10,10,10,0,0,0,0,0,0,0,0,0,0,0,0,0,0,0,0,0,0,0,0,0,0,10,10,0,0,0,0,0,0,0,0,0,0,0,0,0,0,0,10,10,0,10,10],
        [10,10,10,10,0,0,0,0,0,0,0,0,0,0,0,0,0,0,0,0,0,0,0,0,0,0,0,0,10,10,0,0,0,0,10,0,0,0,0,0,0,0,0,0,0,10,10,10,10,10],
        [10,10,0,0,0,0,0,0,0,0,0,0,0,0,0,0,0,10,10,0,0,0,0,0,0,0,0,0,10,10,10,0,0,0,10,10,0,0,0,0,0,0,0,0,10,10,0,10,0,10],
        [10,0,0,0,0,0,0,0,0,0,0,0,0,0,0,0,0,10,10,0,0,0,0,0,0,0,0,0,10,10,10,10,10,10,10,0,0,0,0,0,0,0,0,0,10,10,10,10,0,10],
        [10,0,0,0,0,0,0,0,0,0,0,0,0,0,0,0,10,10,10,0,0,0,0,0,0,0,0,0,10,10,10,10,10,10,10,0,0,0,0,0,10,0,0,0,0,10,10,0,0,10],
        [10,0,0,0,0,0,0,10,10,0,0,0,0,0,0,0,10,0,10,0,0,0,0,0,0,0,0,0,0,10,10,10,10,10,0,0,0,0,0,0,10,0,0,0,10,10,0,0,0,10],
        [10,0,0,0,0,0,0,10,0,0,0,0,0,0,0,0,10,0,10,0,0,0,0,0,0,0,0,0,0,10,10,10,10,10,0,0,0,0,0,0,0,10,0,10,10,0,0,0,0,10],
        [10,0,0,0,0,0,10,10,0,0,0,0,0,0,10,10,0,0,10,0,0,0,0,0,0,0,0,0,0,10,10,10,0,10,0,0,0,0,0,0,0,10,10,10,10,0,0,0,0,10],
        [10,0,0,0,0,10,10,0,0,0,0,0,0,0,10,10,0,0,10,0,0,0,0,0,0,10,10,10,10,10,10,10,10,10,10,0,0,0,0,0,0,0,10,0,10,0,0,0,0,10],
        [10,0,0,10,10,10,0,0,0,0,0,0,0,0,10,10,0,0,10,0,0,0,10,10,10,10,10,10,10,10,10,10,10,10,10,0,0,0,0,0,0,0,10,10,10,0,0,0,0,10],
        [10,10,10,10,0,0,0,0,0,0,0,0,0,0,10,10,0,10,0,0,0,0,0,0,0,10,10,10,10,0,10,10,10,10,10,0,0,0,0,0,0,0,10,0,10,0,0,0,0,10],
        [10,10,10,10,0,0,10,10,0,0,0,0,0,0,10,10,0,10,0,0,0,0,0,0,0,0,0,0,10,10,10,0,10,10,10,0,0,0,0,0,0,0,0,0,10,0,0,0,0,10],
        [10,0,10,10,10,10,10,10,0,0,0,0,0,0,10,10,0,10,0,0,0,0,0,0,0,0,0,0,0,0,0,10,10,10,10,0,0,0,0,0,0,0,0,10,10,0,0,0,0,10],
        [10,10,10,10,10,0,10,0,0,0,0,0,0,10,10,10,0,10,0,0,0,0,0,0,0,0,0,0,0,0,0,0,10,10,10,0,0,0,0,0,0,0,0,0,0,0,0,0,0,10],
        [10,10,10,10,10,10,10,10,0,0,0,0,0,10,10,10,10,10,0,0,0,0,0,0,0,0,0,0,0,0,0,0,10,10,10,0,0,0,0,0,0,0,0,0,0,0,0,0,0,10],
        [10,10,10,10,10,10,10,10,0,0,0,0,0,10,10,10,10,10,0,0,0,0,0,0,0,0,0,0,0,0,10,10,10,10,10,0,0,0,0,0,0,0,0,0,0,0,0,0,0,10],
        [10,0,10,10,10,10,10,0,0,0,0,0,0,10,0,10,10,10,0,0,0,0,0,0,0,0,0,0,0,10,10,10,10,10,10,0,0,0,0,0,0,0,0,0,0,0,0,0,0,10],
        [10,10,10,10,10,10,10,0,0,0,0,0,0,10,10,10,10,0,0,0,0,0,0,0,0,0,0,10,10,10,10,10,10,10,10,0,0,0,0,0,0,0,0,0,0,0,0,0,0,10],
        [10,10,10,10,10,10,10,0,0,0,0,0,0,0,10,10,10,10,0,0,0,0,0,0,0,0,0,10,10,10,10,10,10,10,10,0,0,0,0,0,0,0,0,0,0,0,0,0,0,10],
        [10,10,10,10,10,10,10,10,10,10,10,10,10,10,10,10,10,10,10,10,10,10,10,10,10,10,10,10,10,10,10,10,10,10,10,10,10,10,10,10,10,10,10,10,10,10,10,10,10,10]
    ]
]
